4,4,4,4,4,4,4,4
4,4,4,4,4,4,4,4
4,4,4,4,4,4,4,4
4,4,4,4,4,4,4,4
4,4,4,28,29,4,4,4
4,4,4,4,9,4,4,4
4,4,4,4,14,4,4,4
4,4,0,1,1,2,4,4
4,0,26,6,6,25,2,4
4,10,21,6,6,20,12,4
4,4,10,22,11,12,4,4
4,4,4,13,4,4,4,4
4,4,4,4,4,4,4,4
4,4,4,4,4,4,4,4
4,4,4,4,4,4,4,4
4,4,4,4,4,4,4,4
